33233333322222223322
33323323333332200002
22223332222223333333
22322222222224333333
22222322233333333333
22233333000333332222
33333222233333322222
22222222222223333333
22233223333002332333
33333333332222222222
00000004000000000000
22220033302033333300
22222222222200022222
22222220002200000222
00333322222220002222
22222222220020000220
00000000202002002022
00002222200222000222
00000022222222222222
00000000022200022222
33233333322222223322
33323323333332200002
22223332222223333333
22322222222224333333
22222322233333333333
22233333000333332222
33333222233333322222
22222222222223333333
22233223333002332333
33333333332222222222
00000004000000000000
22220033302033333300
22222222222200022222
22222220002200000222
00333322222220002222
22222222220020000220
00000000202002002022
00002222200222000222
00000022222222222222
00000000022200022222
33233333322222223322
33323323333332200002
22223332222223333333
22322222222224333333
22222322233333333333
22233333000333332222
33333222233333322222
22222222222223333333
22233223333002332333
33333333332222222222
00000004000000000000
22220033302033333300
22222222222200022222
22222220002200000222
00333322222220002222
22222222220020000220
00000000202002002022
00002222200222000222
00000022222222222222
00000000022200022222
33233333322222223322
33323323333332200002
22223332222223333333
22322222222224333333
22222322233333333333
22233333000333332222
33333222233333322222
22222222222223333333
22233223333002332333
33333333332222222222
00000004000000000000
22220033302033333300
22222222222200022222
22222220002200000222
00333322222220002222
22222222220020000220
00000000202002002022
00002222200222000222
00000022222222222222
00000000022200022222
33233333322222223322
33323323333332200002
22223332222223333333
22322222222224333333
22222322233333333333
22233333000333332222
33333222233333322222
22222222222223333333
22233223333002332333
33333333332222222222
00000004000000000000
22220033302033333300
22222222222200022222
22222220002200000222
00333322222220002222
22222222220020000220
00000000202002002022
00002222200222000222
00000022222222222222
00000000022200022222
33233333322222223322
33323323333332200002
22223332222223333333
22322222222224333333
22222322233333333333
22233333000333332222
33333222233333322222
22222222222223333333
22233223333002332333
33333333332222222222
00000004000000000000
22220033302033333300
22222222222200022222
22222220002200000222
00333322222220002222
22222222220020000220
00000000202002002022
00002222200222000222
00000022222222222222
00000000022200022222
33233333322222223322
33323323333332200002
22223332222223333333
22322222222224333333
22222322233333333333
22233333000333332222
33333222233333322222
22222222222223333333
22233223333002332333
33333333332222222222
00000004000000000000
22220033302033333300
22222222222200022222
22222220002200000222
00333322222220002222
22222222220020000220
00000000202002002022
00002222200222000222
00000022222222222222
00000000022200022222
33233333322222223322
33323323333332200002
22223332222223333333
22322222222224333333
22222322233333333333
22233333000333332222
33333222233333322222
22222222222223333333
22233223333002332333
33333333332222222222
00000004000000000000
22220033302033333300
22222222222200022222
22222220002200000222
00333322222220002222
22222222220020000220
00000000202002002022
00002222200222000222
00000022222222222222
00000000022200022222
33233333322222223322
33323323333332200002
22223332222223333333
22322222222224333333
22222322233333333333
22233333000333332222
33333222233333322222
22222222222223333333
22233223333002332333
33333333332222222222
00000004000000000000
22220033302033333300
22222222222200022222
22222220002200000222
00333322222220002222
22222222220020000220
00000000202002002022
00002222200222000222
00000022222222222222
00000000022200022222
33233333322222223322
33323323333332200002
22223332222223333333
22322222222224333333
22222322233333333333
22233333000333332222
33333222233333322222
22222222222223333333
22233223333002332333
33333333332222222222
00000004000000000000
22220033302033333300
22222222222200022222
22222220002200000222
00333322222220002222
22222222220020000220
00000000202002002022
00002222200222000222
00000022222222222222
00000000022200022222