00041114003333333330
00041114003333333330
00041114003333333330
00004111400333333300
00000411140033333333
00000041114003333333
00000041114000333333
00000041114000033333
00000041114000000033
02200411140000000000
22224111400000002200
22224111400000022222
22204111400000222222
22204111400000222222
22004111400000022220
22224111400000002200
22224111400000022222
22204111400000222222
22204111400000222222
22004111400000022220
22224111400000002200
22224111400000022222
22204111400000222222
22204111400000222222
22004111400000022220
22224111400000002200
22224111400000022222
22204111400000222222
22204111400000222222
22004111400000022220
00041114003333333330
00041114003333333330
00004111400333333300
00000411140033333333
00000041114003333333
00000041114000333333
00000041114000033333
00000041114000000033
02200411140000000000
22224111400000002200
22224111400000022222
22204111400000222222
22204111400000222222
22004111400000022220
22224111400000002200
22224111400000022222
22204111400000222222
22204111400000222222
22004111400000022220
22224111400000002200
22224111400000022222
22204111400000222222
22204111400000222222
22004111400000022220
22224111400000002200
22224111400000022222
22204111400000222222
22204111400000222222
22004111400000022220
00041114003333333330
00041114003333333330
00004111400333333300
00000411140033333333
00000041114003333333
00000041114000333333
00000041114000033333
00000041114000000033
02200411140000000000
22224111400000002200
22224111400000022222
22204111400000222222
22204111400000222222
22004111400000022220
22224111400000002200
22224111400000022222
22204111400000222222
22204111400000222222
22004111400000022220
22224111400000002200
22224111400000022222
22204111400000222222
22204111400000222222
22004111400000022220
22224111400000002200
22224111400000022222
22204111400000222222
22204111400000222222
22004111400000022220
00041114003333333330
00041114003333333330
00004111400333333300
00000411140033333333
00000041114003333333
00000041114000333333
00000041114000033333
00000041114000000033
02200411140000000000
22224111400000002200
22224111400000022222
22224111400000022222
00041114003333333330
00041114003333333330
00041114003333333330
00004111400333333300
00000411140033333333
00000041114003333333
00000041114000333333
00000041114000033333
00000041114000000033
02200411140000000000
22224111400000002200
22224111400000022222
22204111400000222222
22204111400000222222
22004111400000022220
22224111400000002200
22224111400000022222
22204111400000222222
22204111400000222222
22004111400000022220
22224111400000002200
22224111400000022222
22204111400000222222
22204111400000222222
22004111400000022220
22224111400000002200
22224111400000022222
22204111400000222222
22204111400000222222
22004111400000022220
00041114003333333330
00041114003333333330
00004111400333333300
00000411140033333333
00000041114003333333
00000041114000333333
00000041114000033333
00000041114000000033
02200411140000000000
22224111400000002200
22224111400000022222
22204111400000222222
22204111400000222222
22004111400000022220
22224111400000002200
22224111400000022222
22204111400000222222
22204111400000222222
22004111400000022220
22224111400000002200
22224111400000022222
22204111400000222222
22204111400000222222
22004111400000022220
22224111400000002200
22224111400000022222
22204111400000222222
22204111400000222222
22004111400000022220
00041114003333333330
00041114003333333330
00004111400333333300
00000411140033333333
00000041114003333333
00000041114000333333
00000041114000033333
00000041114000000033
02200411140000000000
22224111400000002200
22224111400000022222
22204111400000222222
22204111400000222222
22004111400000022220
22224111400000002200
22224111400000022222
22204111400000222222
22204111400000222222
22004111400000022220
22224111400000002200
22224111400000022222
22204111400000222222
22204111400000222222
22004111400000022220
22224111400000002200
22224111400000022222
22204111400000222222
22204111400000222222
22004111400000022220
00041114003333333330
00041114003333333330
00004111400333333300
00000411140033333333
00000041114003333333
00000041114000333333
00000041114000033333
00000041114000000033
02200411140000000000
22224111400000002200
22224111400000022222
22224111400000022222
