22222222444422222222
22222422222422222022
22222242222222222242
22222222222222422220
24444422222222222202
42222242222422224222
22242222222202222222
22222422222222220222
02222222222224222222
24444222224444222242
22222222444422222222
22222422222422222022
22222242222222222242
22222222222222422220
24444422222222222202
42222242222422224222
22242222222202222222
22222422222222220222
02222222222224222222
24444222224444222242
22222222444422222222
22222422222422222022
22222242222222222242
22222222222222422220
24444422222222222202
42222242222422224222
22242222222202222222
22222422222222220222
02222222222224222222
24444222224444222242
22222222444422222222
22222422222422222022
22222242222222222242
22222222222222422220
24444422222222222202
42222242222422224222
22242222222202222222
22222422222222220222
02222222222224222222
24444222224444222242
22222222444422222222
22222422222422222022
22222242222222222242
22222222222222422220
24444422222222222202
42222242222422224222
22242222222202222222
22222422222222220222
02222222222224222222
24444222224444222242
22222222444422222222
22222422222422222022
22222242222222222242
22222222222222422220
24444422222222222202
42222242222422224222
22242222222202222222
22222422222222220222
02222222222224222222
24444222224444222242
22222222444422222222
22222422222422222022
22222242222222222242
22222222222222422220
24444422222222222202
42222242222422224222
22242222222202222222
22222422222222220222
02222222222224222222
24444222224444222242
22222222444422222222
22222422222422222022
22222242222222222242
22222222222222422220
24444422222222222202
42222242222422224222
22242222222202222222
22222422222222220222
02222222222224222222
24444222224444222242
22222222444422222222
22222422222422222022
22222242222222222242
22222222222222422220
24444422222222222202
42222242222422224222
22242222222202222222
22222422222222220222
02222222222224222222
24444222224444222242
22222222444422222222
22222422222422222022
22222242222222222242
22222222222222422220
24444422222222222202
42222242222422224222
22242222222202222222
22222422222222220222
02222222222224222222
24444222224444222242
22222222444422222222
22222422222422222022
22222242222222222242
22222222222222422220
24444422222222222202
42222242222422224222
22242222222202222222
22222422222222220222
02222222222224222222
24444222224444222242
22222222444422222222
22222422222422222022
22222242222222222242
22222222222222422220
24444422222222222202
42222242222422224222
22242222222202222222
22222422222222220222
02222222222224222222
24444222224444222242
22222222444422222222
22222422222422222022
22222242222222222242
22222222222222422220
24444422222222222202
42222242222422224222
22242222222202222222
22222422222222220222
02222222222224222222
24444222224444222242
22222222444422222222
22222422222422222022
22222242222222222242
22222222222222422220
24444422222222222202
42222242222422224222
22242222222202222222
22222422222222220222
02222222222224222222
24444222224444222242
22222222444422222222
22222422222422222022
22222242222222222242
22222222222222422220
24444422222222222202
42222242222422224222
22242222222202222222
22222422222222220222
02222222222224222222
24444222224444222242
22222222444422222222
22222422222422222022
22222242222222222242
22222222222222422220
24444422222222222202
42222242222422224222
22242222222202222222
22222422222222220222
02222222222224222222
24444222224444222242
22222222444422222222
22222422222422222022
22222242222222222242
22222222222222422220
24444422222222222202
42222242222422224222
22242222222202222222
22222422222222220222
02222222222224222222
24444222224444222242
22222222444422222222
22222422222422222022
22222242222222222242
22222222222222422220
24444422222222222202
42222242222422224222
22242222222202222222
22222422222222220222
02222222222224222222
24444222224444222242
22222222444422222222
22222422222422222022
22222242222222222242
22222222222222422220
24444422222222222202
42222242222422224222
22242222222202222222
22222422222222220222
02222222222224222222
24444222224444222242
22222222444422222222
22222422222422222022
22222242222222222242
22222222222222422220
24444422222222222202
42222242222422224222
22242222222202222222
22222422222222220222
02222222222224222222
24444222224444222242